1111111111111111
11111E0000P11111
1111100000011111
1111111001111111
1111111001111111
1C00C110011C00C1
1000011001100001
1000000000000001
1000000000000001
1000011001100001
1C00C110011C00C1
1111111001111111
1111111001111111
1111110000111111
111111C00C111111
1111111111111111
