1111111111111111111111111111111111111111111111111111111111111111111111111
1111110011100000000000000000000000000000000000000000000000000000000001001
1000000000001000000000000000111111111000110000001000000100000001000000111
1000011110001000111111100000111111111100011000000100000010000000100000011
11000000000010001CCCCCC000000000000001100011000C0000000011111111111100001
11001111110010001C1111100001111111111100011000000100000010000000100000011
11001111110010001C1111100000111111111000110000001000000100000001000000111
10011111111000001C1P11100000111111111100011000000100000010000000100000011
10011111111000001C1C11100000001111111000100000010000001000000010000001001
10011111111000001C1C11100000011111111111100110000001000000100000001000001
10000000000010001C1C11100000000000001111100100000000000011111111111100001
10001111111000001CCC11100000111111111100011000000100000010000000100000011
1100000000001000111111100000111111111000110000001000000100000001000000111
1100111111100000000000000000111111111100011000000100000010000000100000011
1100000000001000000000000110000000000110001100000000000011111111111100001
1100111111100001111111111000111111111100011000000100000010000000100000011
1000000000001001111111111100111111111000110000001000000100000001000000111
1000111111100001111111111000111111111100011000000100000010000000100000011
1001111111100000000000000000000000000000000000000000000000000000000001001
1001111111100000111111111000011111111111100110000001000000100000001000001
1000000000001000000000000000000000001111100100000000000011111111111100001
1000011111100001111111111000111111111100011000000100000010000000100000011
1000000000001001111111111100111111111000110000001000000100000001000000111
1000011111000001111111111000111111111100011000000100000010000000100000011
11000000000110000000000001100000000001100011000C0000000011111111111100001
1100011111111001111111111000111111111100011000000100000010000000100000011
1100011111111001111111111100111111111000110000001000000100000001000000111
1000011111110001111111111000111111111100011000000100000010000000100000011
1001111111110000001000000100000010000000100000010000E01000000010000001001
1001111111111000111111111000011111111111100110000001000000100000001000001
1000011111111000000000010000000000001111100100000000000011111111111100001
1000011111100001111111111000111111111100011000000100000010000000100000011
1000000000001001111111111100111111111000110000001000000100000001000000111
1000011111100001111111111000111111111100011000000100000010000000100000011
1000000000001000000000000110000000000110001100000000000011111111111100001
1000011111100001111111111000111111111100011000000100000010000000100000011
1000000000001001111111111100111111111000110000001000000100000001000000111
1000011111100001111111111000111111111100011000000100000010000000100000011
1001000000000000000000000000000000000000000000000000000000000000000001001
1001111111000000111111111000011111111111100110000001000000100000001000001
1000000000001000000000000000000000001111100100000000000011111111111100001
1000011111100001111111111000111111111100011000000100000010000000100000011
1000000000001001111111111100111111111000110000001000000100000001000000111
1000011111100001111111111000111111111100011000000100000010000000100000011
10000000000010000000000001100000000001100011000C0000000011111111111100001
1000011111100001111111111000111111111100011000000100000010000000100000011
1000000000011001111111111100111111111000110000001000000100000001000000111
1000011111110001111111111000111111111100011000000100000010000000100000011
1001000000100000001000000100000010000000100000010000001000000010000001001
1001111111110000111111111000011111111111100110000001000000100000001000001
1000000000011000000000010000000000001111100100000000000011111111111100001
1000011111110001111111111000111111111100011000000100000010000000100000011
1000000000011001111111111100111111111000110000001000000100000001000000111
1000011111110001111111111000111111111100011000000100000010000000100000011
1000000000011000000000000010000000000110001100000000000011111111111100001
1000011111110001111111111000111111111100011000000100000010000000100000011
1000000000011001111111111100111111111000110000001000000100000001000000111
1000011111110001111111111000111111111100011000000100000010000000100000011
1001000000100000000000000000000000000000000000000000000000000000000001001
1001111111110000111111111000011111111111100110000001000000100000001000001
1000000000001000000000000000000000001111100100000000111100000001111100001
1000011111100001111111111000111111111100011000000100000010000000100000011
1000001111001001111111111100111111111000111000001001100100000001000000111
1000011111100001111111111000111111111100011000000100000010000000100000011
10000011110010000000000000100000000000000000000C000000001111C001111100001
1000011111100001111111111000111111111100011000000100000010000000100000011
1000001111001001111100011100111111111000111000001001100100000001000000111
100001111110000111110C011000111111111100011000000101000010000000100000011
1001000000000000001100000000000000000000000000010000001000000010000001001
1001111111110000111111111000011101111111100110000011000000100000001000001
1000011111111000000000010000000000001111100111000010000011110001111100001
1000011111110001111111111000111C11111100001110000100000010000000100000011
1000011111111001111111111100111111111000111000001100100100000001000000111
1000011111110001111111111000111111111100011000000100000010000000100000011
1000011111111000000000000010000000000C00011100000000000011111111111100001
1000011111110001111111111000111111111100011000000100000010000000100000011
1000000000000001111111111100111111111000111000001000000100000001000000111
1000011111110000111111000000111111111100011000000100000010000000100000011
11111111111111100000C0011111111111111111111111111111111111111111111111111
1111111111111111111111111111111111111111111111111111111111111111111111111
