1111111111111111111111111111
1111111111111111111111111111
1111111111111111111111111111
1111111111111111111111111111
1111111110000C00000111111111
1111111110000000000111111111
1111111110000P00000111111111
1111111111110000111111111111
1111111111110000111111111111
1111000000000000011111C01111
1111000000000000011111001111
11110111110C1110011C11001111
1111011111011111000000001111
1111011E11011111000000001111
1111000000011111000000001111
111100000000111C000000001111
1111000000000000000000001111
1111000000011111100000001111
1111111110011111100111111111
111111111001110C000111111111
1111111110011100000111111111
1111111110000000000111111111
1111111110000000000111111111
1111111111111111111111111111
1111111111111111111111111111
1111111111111111111111111111
1111111111111111111111111111
