111111111111
1C0100100001
100P00001001
1100010C1001
1C10010001E1
111111111111
