1111111111
100PEc0001
1111111111
