11111
111P1
1C101
11401
1E011
11111
