1111111111111111
11111111CC111111
111CC111CC111111
111CC11100111111
11100000001CC111
1000000000100111
1000111000100111
1000CC1000000111
1111111000001111
1E00000000001111
1C11111110001111
1CCCP11110000001
111111111C000001
1111111111111101
1111111111111C01
1111111111111111
