1111111111111111111111111111111111111111111111111111111111111111
1000110000000011111111111111111011100000111110000111111111111111
10P0110011100011111111111000000011100000000000000111111111111111
100011000C000011100011000000000011100000000000000111111111111111
11C1110000000011100011000111110000000000111110000C11111111111111
11C1110000000011100000000111110000000000111110000011111111111111
11C1110111100000000000000111111011100000111110001111111111111111
11000000111000000111111101111110111000001111100011100000C1111111
110C00C011100000011111110111111011100000111110001110000001111111
110000001111110000000000C000000011100000111110000000000000000001
110000001111110001111111011111101110000000C000000000000000000001
110C00C011111100011111110111111011100000111110000000000000000001
1100000011111100011111110111111011100000111110000000000000000001
1101111000000000000000000000111011100000111111111111110000000001
1101111000000000000000000000111011100000000001111111110000000001
11000000100010000C00100C0000111011100000000001111111110000000001
11110C1111111000000010000000111011100000000000000000000000000001
1111C01111111000000010000000000011100000000000000000000000000001
11110C11111110000000000000000C0011100000000000000000000000000001
1100000011111000001110000000000011100000000000100000000010000001
1100000000000000001110001111111011100000000000100000000010000001
11000000000000000C1110000C00111011100000000000100000000010000001
110000001111100001111000000011101110000000000010000C000010000001
1111000011111000000000000000111011100000000000111111111110000001
11110000C1111111111111111111111000000000000000000000000000000001
111100001111111111111111111111100000000000000000C000000000C00001
111C0000111111111111111111111110000000000C0000000000000000000001
1111000011111111111111111111111011100000000000000000000C00000001
11110000C1111111111111111111111011100000000000000000000000000001
1111000011111111111111111111111011111111111111100001111111111111
1111000011111111111111111111110001111111111111100001111111111111
1000000000000000000000000000000E00000000000000000000000000000001
1111000000000000000000000000010001111111111111111111110000000001
1111000000000011111000101000011000000011111000000000000000CC0001
11110000000000111110000C0000011000000011111011111110000000CC0001
1111000000000011111000101000011000000000000011111110000000000001
1111111111100000000000000000000011111111111111111111110000000001
1111111111100000000001111100000011111111111111111111111111111111
1111111111101100001101111100000011111111111111111111111111111111
11111111111011C11C1101111111111011111111111111111111111111111111
1111111111100000000001111111111011111111111111111111111111111111
1111111111111111111111111111111111111111111111111111111111111111
