11111111111111
10C00C00C00C01
10000000000001
10C00C00C00C01
10000000000001
10C00C00C00C01
10000000000001
10C00C00C00C01
10000000000001
10C00C00C00C01
10000000000001
10C00C00C00C01
1P0000000000E1
11111111111111
