11111111111
1CC01110CC1
1CC01110CC1
10001110001
11100E00111
11100000111
11100C00111
10001C10001
1CC01C10CC1
1CC01C10CC1
11111P11111
11111111111
