1111111111111111
1111111111000011
11111000010C0011
111110CC01000011
111110CC0100C011
1000PC0001100011
10CC0111E0001111
1000011110C01111
1111111110001111
1111111111111111
