111111111111111
1000000C0000001
101111111111101
101000111000101
1010C01110C0101
101000000000101
1010000P0000101
101000000000101
1010C01010C0101
101000101000101
101111101111101
1000000E0000001
111111111111111
